0000000000000000
0000001111110000
0000111222211000
0000122211221000
0011151122121000
0112222233121000
0122525143121000
0125527134121110
0122552133122210
0112222133522210
0011151132121110
0000122111221000
0000112222211000
0000011111110000
0000000000000000
0000000000000000