0000000000000000
0000000000000000
0000000000000000
0000000000000000
0000001111110000
0000001322210000
0000111522210000
0000122222210000
0000122262210000
0000111111110000
0000000000000000
0000000000000000
0000000000000000
0000000000000000
0000000000000000
0000000000000000