0000000000000000
0000000000000000
0000000000000000
0000000000000000
0000001110000000
0000001310000000
0000001211110000
0000111522210000
0000122262210000
0000111111110000
0000000000000000
0000000000000000
0000000000000000
0000000000000000
0000000000000000
0000000000000000