0000000000000000
0000000000000000
0000000000000000
0000000000000000
0000111110000000
0000122310000000
0000122211110000
0000122525310000
0000132561110000
0000111111000000
0000000000000000
0000000000000000
0000000000000000
0000000000000000
0000000000000000
0000000000000000