0000000000000000
0000000000000000
0000000000000000
0000000000000000
0000001110000000
0000001310000000
0000001211110000
0000111525310000
0000132561110000
0000111151000000
0000000131000000
0000000111000000
0000000000000000
0000000000000000
0000000000000000
0000000000000000