0000000000000000
0000000000000000
0000000000000000
0000000000000000
0000001111100000
0000111227100000
0000122532110000
0000122353210000
0000111245210000
0000001222110000
0000001111100000
0000000000000000
0000000000000000
0000000000000000
0000000000000000
0000000000000000