0000000000000000
0000000000000000
0011111111111000
0011221122211000
0011222522211000
0011521112511000
0011213331211000
0011213331211000
0012522522521000
0012222212271000
0011111111111000
0000000000000000
0000000000000000
0000000000000000
0000000000000000
0000000000000000
