0000000000000000
0000000000000000
0000000000000000
0000111111110000
0000135227110000
0000122532210000
0000122353210000
0000113245210000
0000152222110000
0000111111110000
0000000000000000
0000000000000000
0000000000000000
0000000000000000
0000000000000000
0000000000000000
