0000000000000000
0000000000000000
0001111111111000
0001122222221000
0001222151521000
0001255223531000
0001281113331000
0001111111111000
0000000000000000
0000000000000000
0000000000000000
0000000000000000
0000000000000000
0000000000000000
0000000000000000
0000000000000000
