0000000000000000
0000000000000000
0000000000000000
0000000000000000
0000111111100000
0000132323100000
0000125552100000
0000135753100000
0000125552100000
0000132323100000
0000111111100000
0000000000000000
0000000000000000
0000000000000000
0000000000000000
0000000000000000